10.ox
..oo....oo
oo.oo....o
..ooo..oo.
....ooo.o.
o.......oo
.....o.o..
.....o....
.......o..
..o.o....o
.o.o...o.o
